%%%%%%%%%%%%%%%%%%%%%%%%%%%%%%
%.      % % %  .           %.%
%       % % %%%%%% %%%%%%% % %
%      .%        %   . % %   %
%%%%% %%%%% %%% %% %%%%% % %%%
%   % % % %   %    %     %   %
% %%% % % % %%%%%%%% %%% %%% %
%       %     %%     % % %   %
%%% % %%%%%%% %%%% %%% % % % %
% %   .       %%     %    o% %
% % %%%%% % %%%% % %%% %%% % %
%   %     %      % %   % %%% %
%.  %P%%%%%   .  % %%% %    .%
%%%%%%%%%%%%%%%%%%%%%%%%%%%%%%
